11111111111111111111111111111111111
1C00E011111111111111111111111111111
10100011111111111111111111111111111
10100011111111111111111111111111111
1P000011111111111111111111111111111
10000011111111111111111111111111111
11111111111111111111111111111111111
